##################
#................#
#.==============.#
#.=%@@%%@@%%@@%=.#
#.==============.#
#................#
##################
