==================
###..###..###..###
##%###%####%###%##
######@@@@@@######
##.##..####..##.##
###%...%..%...%###