##################
#==.....%%.....==#
#.==....%%....==.#
#..==..%..%..==..#
#..==.%%..%%.==..#
#....==.....==...#
##################
