##################
####@==%%==@@=####
#..@@%%..==%%..@.#
#.=%%==@@==@@==%.#
#.@..==%%..@@%%..#
####=@@==%%==@@###
##################
