##################
#.=%@.=%@.=%@.=%@#
#@%=.@%=.@%=.@%=.#
#.=%@.=%@.=%@.=%@#
#@%=.@%=.@%=.@%=.#
##################
