=################=
=###@@##@@##@@###=
=###..%%..%%..###=
=###..%%..%%..###=
=###@@##@@##@@###=
=################=
