..................
.......@@@@.......
......@####@......
....#%%%==%%%#....
..%%%==####==%%%..
...==...==...==...
##...###..###...##
