.##########.
##%%%%%%%%##
#%%@@%%@@%%#
#%%@@%%@@%%#
#%%%%%%%%%%#
#%%%%%%%%%%#
#%%@@@@@@%%#
#%%%@@@@%%%#
##%%%%%%%%##
.##########.