...###......###...
..#@@########@@#..
.#@@@%%=##=%%@@@#.
.#@@@%%====%%@@@#.
..#@@@%%==%%@@@#..
...##@@%%%%%@@##..
....##@%%%%@##....
......#@%%@#......
.......#@@#.......
........##........