%########===########%
##...@==@...@==@...##
##...@==@...@==@...##
%####.###...###.####%
%.@@@#%%.#%#.%%#@@@.%
%####.###...###.####%
##...@==@...@==@...##
##...@==@...@==@...##
%########===########%